//MAP CONVERTED BY dmm2tgm.py THIS HEADER COMMENT PREVENTS RECONVERSION, DO NOT REMOVE
"a" = (
/obj/structure/window/reinforced{
	dir = 1
	},
/turf/open/floor/iron/dark/airless,
/area/shuttle/trader)
"b" = (
/obj/structure/rack/shelf,
/obj/effect/turf_decal/tile/dark_red/diagonal_centre,
/turf/open/floor/iron/dark/textured_edge{
	dir = 8
	},
/area/shuttle/trader)
"c" = (
/obj/machinery/power/shuttle_engine/propulsion/burst/left,
/turf/open/space/basic,
/area/shuttle/trader)
"d" = (
/obj/structure/window/reinforced{
	dir = 4
	},
/obj/machinery/atmospherics/components/unary/vent_pump/on{
	dir = 1
	},
/turf/open/floor/iron/dark/airless,
/area/shuttle/trader)
"e" = (
/obj/structure/rack/shelf,
/obj/effect/turf_decal/tile/dark_red/diagonal_centre,
/turf/open/floor/iron/dark/textured_edge{
	dir = 1
	},
/area/shuttle/trader)
"f" = (
/obj/structure/rack/shelf,
/obj/effect/turf_decal/tile/dark_red/diagonal_centre,
/turf/open/floor/iron/dark/textured_corner{
	dir = 8
	},
/area/shuttle/trader)
"g" = (
/obj/effect/spawner/structure/window/reinforced/plasma/plastitanium,
/turf/open/floor/plating,
/area/shuttle/trader)
"h" = (
/obj/structure/closet/cabinet,
/turf/open/floor/carpet/red,
/area/shuttle/trader)
"i" = (
/obj/structure/chair/comfy/shuttle{
	dir = 1
	},
/turf/open/floor/pod/dark{
	icon = 'icons/turf/floors.dmi'
	},
/area/shuttle/trader)
"j" = (
/turf/open/floor/carpet/red,
/area/shuttle/trader)
"k" = (
/obj/structure/rack/shelf,
/obj/effect/turf_decal/tile/dark_red/half{
	dir = 4
	},
/turf/open/floor/iron/dark/textured_corner{
	dir = 8
	},
/area/shuttle/trader)
"l" = (
/obj/machinery/door/window/survival_pod{
	dir = 4
	},
/turf/open/floor/iron/dark/airless,
/area/shuttle/trader)
"m" = (
/turf/open/floor/iron/dark/textured_edge{
	dir = 1
	},
/area/shuttle/trader)
"n" = (
/obj/effect/turf_decal/box/blue,
/turf/open/floor/iron/dark/airless,
/area/shuttle/trader)
"o" = (
/turf/open/floor/pod/dark{
	icon = 'icons/turf/floors.dmi'
	},
/area/shuttle/trader)
"p" = (
/obj/machinery/power/smes/magical,
/obj/structure/cable,
/turf/open/floor/catwalk_floor/iron_dark,
/area/shuttle/trader)
"q" = (
/obj/machinery/door/window/survival_pod{
	dir = 1
	},
/obj/structure/window/reinforced{
	dir = 8
	},
/obj/effect/mapping_helpers/airlock/access/any/away/generic4,
/turf/open/floor/iron/dark/airless,
/area/shuttle/trader)
"r" = (
/turf/open/floor/iron/dark/airless,
/area/shuttle/trader)
"s" = (
/obj/structure/rack/shelf,
/obj/effect/turf_decal/tile/dark_red/half{
	dir = 8
	},
/turf/open/floor/iron/dark/smooth_corner,
/area/shuttle/trader)
"t" = (
/obj/machinery/power/apc/auto_name/directional/north,
/obj/structure/cable,
/turf/open/floor/catwalk_floor/iron_dark,
/area/shuttle/trader)
"u" = (
/obj/structure/window/reinforced{
	dir = 1
	},
/obj/machinery/power/shuttle_engine/heater,
/turf/open/floor/plating,
/area/shuttle/trader)
"v" = (
/obj/machinery/door/airlock/command{
	id_tag = "syndieprisoncaptainquarterdoor";
	name = "Captain's Quarters";
	req_access = list("syndicate")
	},
/obj/effect/mapping_helpers/airlock/cutaiwire,
/obj/effect/mapping_helpers/airlock/access/any/away/generic4,
/turf/open/floor/pod/dark{
	icon = 'icons/turf/floors.dmi'
	},
/area/shuttle/trader)
"w" = (
/obj/structure/rack/shelf,
/obj/effect/turf_decal/tile/dark_red/half{
	dir = 8
	},
/turf/open/floor/iron/dark/smooth_corner{
	dir = 4
	},
/area/shuttle/trader)
"x" = (
/turf/template_noop,
/area/template_noop)
"y" = (
/obj/structure/rack/shelf,
/obj/effect/turf_decal/tile/dark_red/half{
	dir = 8
	},
/turf/open/floor/iron/dark/textured_edge{
	dir = 8
	},
/area/shuttle/trader)
"z" = (
/turf/open/floor/catwalk_floor/iron_dark,
/area/shuttle/trader)
"A" = (
/turf/closed/wall/mineral/plastitanium,
/area/shuttle/trader)
"B" = (
/obj/machinery/door/window/survival_pod{
	dir = 8
	},
/turf/open/floor/iron/dark/airless,
/area/shuttle/trader)
"C" = (
/obj/structure/bed/double,
/turf/open/floor/carpet/red,
/area/shuttle/trader)
"D" = (
/obj/structure/cable,
/turf/open/floor/catwalk_floor/iron_dark,
/area/shuttle/trader)
"F" = (
/obj/effect/mapping_helpers/airlock/cutaiwire,
/obj/machinery/door/airlock/grunge,
/obj/docking_port/mobile/tradership,
/turf/open/floor/iron/dark/airless,
/area/shuttle/trader)
"G" = (
/obj/structure/cable,
/obj/machinery/power/terminal,
/turf/open/floor/catwalk_floor/iron_dark,
/area/shuttle/trader)
"I" = (
/obj/structure/window/reinforced{
	dir = 8
	},
/obj/machinery/atmospherics/components/unary/vent_pump/on{
	dir = 1
	},
/turf/open/floor/iron/dark/airless,
/area/shuttle/trader)
"J" = (
/obj/machinery/power/shuttle_engine/propulsion/burst/right{
	dir = 1
	},
/turf/open/space/basic,
/area/shuttle/trader)
"K" = (
/obj/structure/bed,
/turf/open/floor/carpet/red,
/area/shuttle/trader)
"L" = (
/obj/machinery/door/airlock/command{
	id_tag = "syndieprisoncaptainquarterdoor";
	name = "Captain's Quarters";
	req_access = list("syndicate")
	},
/obj/effect/mapping_helpers/airlock/access/any/away/generic4,
/obj/effect/mapping_helpers/airlock/cutaiwire,
/turf/open/floor/pod/dark{
	icon = 'icons/turf/floors.dmi'
	},
/area/shuttle/trader)
"M" = (
/obj/effect/turf_decal/box,
/turf/open/floor/iron/dark/airless,
/area/shuttle/trader)
"N" = (
/obj/machinery/atmospherics/components/unary/vent_pump/on{
	dir = 1
	},
/turf/open/floor/iron/dark/airless,
/area/shuttle/trader)
"O" = (
/obj/structure/rack/shelf,
/obj/effect/turf_decal/tile/dark_red/diagonal_centre,
/turf/open/floor/iron/dark/smooth_corner,
/area/shuttle/trader)
"P" = (
/obj/machinery/atmospherics/components/unary/vent_pump/on,
/turf/open/floor/carpet/red,
/area/shuttle/trader)
"Q" = (
/obj/machinery/atmospherics/components/unary/vent_pump/on,
/turf/open/floor/pod/dark{
	icon = 'icons/turf/floors.dmi'
	},
/area/shuttle/trader)
"R" = (
/obj/machinery/atmospherics/components/unary/vent_pump/on,
/obj/structure/chair/comfy/shuttle{
	dir = 1
	},
/turf/open/floor/pod/dark{
	icon = 'icons/turf/floors.dmi'
	},
/area/shuttle/trader)
"S" = (
/obj/effect/mapping_helpers/airlock/cutaiwire,
/obj/effect/mapping_helpers/airlock/access/any/away/generic4,
/obj/machinery/door/airlock/grunge,
/turf/open/floor/iron/dark/airless,
/area/shuttle/trader)
"T" = (
/obj/machinery/atmospherics/components/tank/air{
	dir = 1;
	initialize_directions = 1
	},
/turf/open/floor/catwalk_floor/iron_dark,
/area/shuttle/trader)
"U" = (
/turf/closed/wall/mineral/plastitanium/nodiagonal,
/area/shuttle/trader)
"V" = (
/obj/machinery/door/window/survival_pod{
	dir = 1
	},
/obj/structure/window/reinforced{
	dir = 4
	},
/obj/effect/mapping_helpers/airlock/access/any/away/generic4,
/turf/open/floor/iron/dark/airless,
/area/shuttle/trader)
"X" = (
/obj/structure/rack/shelf,
/obj/effect/turf_decal/tile/dark_red/half{
	dir = 4
	},
/turf/open/floor/iron/dark/textured_edge{
	dir = 4
	},
/area/shuttle/trader)
"Z" = (
/obj/structure/rack/shelf,
/obj/effect/turf_decal/tile/dark_red/diagonal_centre,
/turf/open/floor/iron/dark/airless,
/area/shuttle/trader)

(1,1,1) = {"
x
x
x
x
x
x
x
x
x
x
x
x
x
x
x
x
x
x
x
"}
(2,1,1) = {"
x
x
x
x
x
x
x
x
x
x
x
x
x
x
x
x
x
x
x
"}
(3,1,1) = {"
x
J
A
A
A
A
A
A
A
A
A
x
J
A
A
A
A
A
x
"}
(4,1,1) = {"
J
A
A
j
j
U
o
U
t
T
A
A
A
A
n
M
r
u
c
"}
(5,1,1) = {"
A
A
h
j
P
v
D
D
D
z
U
s
y
w
a
r
r
u
c
"}
(6,1,1) = {"
A
A
U
U
C
U
D
U
U
U
U
m
r
r
V
d
l
u
c
"}
(7,1,1) = {"
A
o
o
U
U
U
D
o
U
O
b
Z
Z
r
r
a
r
A
A
"}
(8,1,1) = {"
g
o
i
o
o
U
D
o
S
m
o
o
o
o
o
a
r
r
A
"}
(9,1,1) = {"
g
o
R
o
Q
L
D
o
U
e
Z
Z
Z
N
r
a
r
r
F
"}
(10,1,1) = {"
g
o
i
o
o
U
D
o
S
m
o
o
o
o
o
a
r
r
A
"}
(11,1,1) = {"
A
o
o
U
U
U
D
o
U
f
Z
Z
Z
r
r
a
r
A
A
"}
(12,1,1) = {"
A
A
U
U
j
U
D
U
U
U
U
m
r
r
q
I
B
u
c
"}
(13,1,1) = {"
A
A
h
j
P
v
D
D
D
z
U
k
X
X
a
r
r
u
c
"}
(14,1,1) = {"
J
A
A
K
K
U
o
U
G
p
A
A
A
A
n
M
r
u
c
"}
(15,1,1) = {"
x
J
A
A
A
A
A
A
A
A
A
x
J
A
A
A
A
A
x
"}
(16,1,1) = {"
x
x
x
x
x
x
x
x
x
x
x
x
x
x
x
x
x
x
x
"}
(17,1,1) = {"
x
x
x
x
x
x
x
x
x
x
x
x
x
x
x
x
x
x
x
"}
